#####################
#s.777777.s.777777.s#
#.77777777.77777777.#
#77#######.#######77#
#77#.....#C#.....#77#
#77#.#~#.....#~#.#77#
#77#.#~#.#C#.#~#.#77#
#77#.....#.#.....#77#
#.7###.##~~~##.###7.#
#s...C.C.~#~.C.C...s#
#.7###.##~~~##.###7.#
#77#.....#.#.....#77#
#77#.#~#.#C#.#~#.#77#
#77#.#~#.....#~#.#77#
#77#.....#C#.....#77#
#77#######.#######77#
#.77777777.77777777.#
#s.777777.s.777777.s#
#####################
