#####################
#s.77.777.s.777.77.s#
#.77.s7777.7777s.77.#
#77#######.#######77#
#77#.....#c#.....#77#
#77#.#~#.....#~#.#77#
#77#.#~#.#c#.#~#.#77#
#77#.....#.#.....#77#
#.7###.##~~~##.###7.#
#s...c.c.~#~.c.c...s#
#.7###.##~~~##.###7.#
#77#.....#.#.....#77#
#77#.#~#.#c#.#~#.#77#
#77#.#~#.....#~#.#77#
#77#.....#c#.....#77#
#77#######.#######77#
#.77.s7777.7777s.77.#
#s.77.777.s.777.77.s#
#####################
