###################
#s.7ccc7.s.7ccc7.s#
#.#7#.#7#.#7#.#7#.#
#777.s777c777s.777#
#c#7#.#7#c#7#.#7#c#
#c7777777c7777777c#
#c#7#7#.#.#.#7#7#c#
#77777.~~~~~.77777#
#.#7#7#~C~C~#7#7#.#
#s.ccc.~~C~~.ccc.s#
#.#7#7#~C~C~#7#7#.#
#77777.~~~~~.77777#
#c#7#7#.#.#.#7#7#c#
#c7777777c7777777c#
#c#.#.#.#c#.#.#.#c#
#777.s777c777s.777#
#.#7#.#7#.#7#.#7#.#
#s.7ccc7.s.7ccc7.s#
###################
