#####################
######ss#############
######..#############
######..#############
######cc#############
#s...c~~c..........s#
#s...c~~c..........s#
######cc#############
######..#############
######..#############
######ss#############
#####################